Pers bana
SPACE
...............
...............
...............
...............
...............
...............
...............
...............
...............
...............
...............
...............
...............
...............
...............
...............
...............
...............
...............
...............
...............
..000..........
..000..........
..000..........
...............
...............
...............
...............
...........000.
...........000.
...........000.
...............
...............
...............
...............
...............
...............
...............
...............
...............
...............
......000......
......000......
......000......
...............
...............
...............
...............
...............
...............
...............
...............
...............
..111..........
..122..........
..232..........
...............
...............
...............
...............
...............
...............
...............
...............
...............
........11122..
........1e123..
........32121..
...............
...............
...............
...............
...............
...............
...............
...............
...............
...............
...............
...............
...............
...............
...............
...............
12333132e123311
.1121.....123..
...21.....32...
...........1...
...........3...
...............
...............
...............
...............
...............
...............
...............
...............
...............
...............
...............
...............
...............
11e223102234440
.......0......0
.......0......0
.......0......0
.......0......0
.......0......0
.......0......0
.......00.....0
........00.e.e0
.........00...0
............e..
...............
...............
...............
...............
...............
...............
...............
...............
...E...........
...............
...............
...............
...............
..........e....
...............
...............
...............
...............
...............
......E........
...............
...............
...............
...............
...............
...............
..........e....
...............
...............
...............
...............
...............
...............
...............
...............
...............
000.........000
063123e32112360
000.........000
0.............0
0.............0
0.............0
0.............0
0.............0
0000.......0000
066412332113560
0000.......0000
0.............0
0.............0
0.............0
0.............0
0.............0
00000.....00000
06664123E145660
00000.....00000
...............
...............
...............
...............
...............
...............
...............
...............
...............
...............
...............
...............
...............
....M..........
...............
...............
...............
...............
...............
..........M....
...............
...............
...............
...............
...............
...............
......M........
...............
...............
...............
...............
...............
...............
...............
...............
...............
...............
...............
....00.1.00....
....00.1.00....
.......1.......
.......2.......
.......2.......
...00..2..00...
...00..3..00...
.......3.......
.......e.......
..00...4...00..
..00...4...00..
.......5.......
.......5.......
.00....6....00.
.00....6....00.
.......E.......
...............
...............
...............
...............
...............
...............
...............
...............
...............
...............
...............
......M.M......
...............
......M.M......
...............
...............
...............
...............
...............
...............
...............
...............
...............
...............
...............
...............
...............
...............
...............
...............
121E333211441e1
...............
...............
...............
123332121331411
...............
...............
...............
14E321324231234
...............
...............
123331211231221
...............
...............
12312332131E233
...............
...............
123332112312312
...............
12122e121212121
...............
122211211122e12
...............
11212e212121121
111111111111111
111111111e11111
111111111111111
111e11111111111
...............
...............
...............
...............
...............
...............
...............
...............
...............
...............
...............
...............
...............
...............
...............
...............
...............
...............
...............
0.............0
0............l0
0.............0
0.............0
0.............0
0.............0
0.............0
0r............0
0.............0
...............
...............
...............
...............
...............
...............
...............
...............
...............
...............
...............
...............
...............
...............
...............
...............
...............
...............
...............
...............
...............
...............
...............
...............
...............
...............
...............
...............
...............
...............
...............
DIALOG
F Do you see that planet down there? That is where you are heading!
B Cool. What's down there?
F It's the lair of Dr. Madness.