SPACE
000000000000000
...............
...............
...............
...............
...............
000000000000000
...............
...............
...............
...............
...............
000000000000000
...............
...............
...............
...............
...............
000000000000000
...............
...............
...............
...............
...............
000000000000000
....0..........
...............
........00.....
...............
00.............
...............
...............
...............
...............
.............00
...............
......00.......
...............
000000000000000
000000000000000
000000000000000
000000000000000
000000000000000
000000000000000
...............
000000000000000
...............
000000000000000
...............
.............00
...............
....0..........
...............
........00.....
...............
00.............
...............
...............
...............
...............
.............00
...............
......00.......
...............
000000000000000
...............
...............
...............
.............00
...............
....0..........
...............
........00.....
...............
00.............
...............
...............
...............
...............
.............00
...............
......00.......
...............
000000000000000
...............
...............
...............
.............00
...............
....0..........
...............
........00.....
...............
00.............
...............
...............
...............
...............
.............00
...............
......00.......
...............
000000000000000
...............
...............
...............
.............00
...............
....0..........
...............
........00.....
...............
00.............
...............
...............
...............
...............
.............00
...............
......00.......
...............
000000000000000
...............
...............
...............
.............00
...............
....0..........
...............
........00.....
...............
00.............
...............
...............
...............
...............
.............00
...............
......00.......
...............
000000000000000
DIALOG