SPACE
000000000000000
...............
...............
...............
........M......
...............
000000000000000
...............
....M..........
...............
.........M.....
...............
000000000000000
...............
...............
...............
....M..........
...............
111111111111111
...............
.........M.....
...M.M.........
.........M.....
...............
000000000000000
....0..........
...............
.....M..00.....
...............
00.............
...............
...............
...............
...............
.............00
...............
......00.......
...............
000000000000000
000000000000000
000000000000000
000000000000000
000000000000000
000000000000000
...............
000000000000000
...............
000000000000000
...............
.............00
...............
....0..........
...............
........00.....
...............
00.............
...............
...............
...............
...............
.............00
...............
......00.......
...............
000000000000000
...............
...............
...............
.............00
...............
....0..........
...............
........00.....
...............
00.............
...............
...............
...............
...............
.............00
...............
......00.......
...............
000000000000000
...............
...............
...............
.............00
...............
....0..........
...............
........00.....
...............
00.............
...............
...............
...............
...............
.............00
...............
......00.......
...............
000000000000000
...............
...............
...............
.............00
...............
....0..........
...............
........00.....
...............
00.............
...............
...............
...............
...............
.............00
...............
......00.......
...............
000000000000000
...............
...............
...............
.............00
...............
....0..........
...............
........00.....
...............
00.............
...............
...............
...............
...............
.............00
...............
......00.......
...............
000000000000000
DIALOG