SPACE
000000000000000
0.............0
0.............0
0.............0
0.............0
0.............0
0.............0
0.............0
0.............0
0.............0
0.............0
0.............0
0.............0
0.............0
0.............0
0.............0
0.............0
0.............0
0.............0
0.............0
0.............0
0.......M.....0
0.............0
0.............0
0...M.........0
0.............0
0........M....0
0.............0
0.............0
0.............0
0.............0
0.............0
0.............0
0.............0
0...M.........0
0.............0
111111111000111
...............
.........M.....
...M.M.........
.........M.....
...............
...............
...............
.....M.........
...............
...............
...............
...............
...............
...............
...............
...............
...............
...............
...............
...............
...............
...............
...............
...............
...............
...............
...............
...............
...............
...............
...............
...............
...............
...............
...............
...............
...............
...............
...............
000000000000000
000000000000000
000000000000000
000000000000000
000000000000000
000000000000000
...............
000000000000000
...............
000000000000000
...............
.............00
...............
....0..........
...............
........00.....
...............
00.............
...............
...............
...............
...............
.............00
...............
......00.......
...............
000000000000000
...............
...............
...............
.............00
...............
....0..........
...............
........00.....
...............
00.............
...............
...............
...............
...............
.............00
...............
......00.......
...............
000000000000000
...............
...............
...............
.............00
...............
....0..........
...............
........00.....
...............
00.............
...............
...............
...............
...............
.............00
...............
......00.......
...............
000000000000000
...............
...............
...............
.............00
...............
....0..........
...............
........00.....
...............
00.............
...............
...............
...............
...............
.............00
...............
......00.......
...............
000000000000000
...............
...............
...............
.............00
...............
....0..........
...............
........00.....
...............
00.............
...............
...............
...............
...............
.............00
...............
......00.......
...............
000000000000000
DIALOG