SPACE
111111111111111
1.............1
1.............1
1.............1
1.............1
1.............1
1.............1
1.............1
1.............1
1.............1
1.............1
1.............1
1.............1
1.............1
1.............1
1.............1
1.............1
1.............1
1..000........1
1.............1
1.............1
1.............1
1.......0.....1
1.............1
1.............1
1.............1
1.............1
1......000....1
1.......000...1
1.......000...1
1.............1
1.............1
1.............1
1.............1
1.............1
1.............1
1.............1
1.............1
1.............1
1.............1
1.............1
1.............1
1.............1
1.............1
1.............1
1.............1
1.............1
1.......m.....1
1.............1
1.......m.....1
1.............1
1.............1
1...m.........1
1.............1
1........m....1
1.............1
1.............1
1.............1
1.............1
1.............1
1.............1
1.............1
1.............1
1.............1
1.............1
1.............1
1.............1
1.............1
1.......M.....1
1.............1
1.............1
1...M.........1
1.............1
1........M....1
1.......M.....1
1.............1
1.............1
1.............1
1.............1
1.............1
1.............1
1.............1
1.............1
1.............1
111111111000111
...............
.........M.....
...M.M.........
.........M.....
...............
...............
...............
.....M.........
...............
...............
...............
...............
...............
...............
...............
...............
...............
...............
...............
.....M.........
.........M.....
......M........
...............
...............
...............
...............
...............
...............
...............
MMMMMMMMMMMMMMM
MMMMMMMMMMMMMMM
MMMMMMMMMMMMMMM
MMMMMMMMMMMMMMM
...............
...............
...............
...............
...............
...............
...............
...............
...............
...............
...............
...............
...............
...............
...............
...............
...............
...............
...............
...............
...............
...............
...............
...............
...............
...............
...............
...............
...............
...............
...............
...............
...............
000000000000000
000000000000000
000000000000000
000000000000000
000000000000000
000000000000000
...............
000000000000000
...............
000000000000000
...............
.............00
...............
....0..........
...............
........00.....
...............
00.............
...............
...............
...............
...............
.............00
...............
......00.......
...............
000000000000000
...............
...............
...............
.............00
...............
....0..........
...............
........00.....
...............
00.............
...............
...............
...............
...............
.............00
...............
......00.......
...............
000000000000000
...............
...............
...............
.............00
...............
....0..........
...............
........00.....
...............
00.............
...............
...............
...............
...............
.............00
...............
......00.......
...............
000000000000000
...............
...............
...............
.............00
...............
....0..........
...............
........00.....
...............
00.............
...............
...............
...............
...............
.............00
...............
......00.......
...............
000000000000000
...............
...............
...............
.............00
...............
....0..........
...............
........00.....
...............
00.............
...............
...............
...............
...............
.............00
...............
......00.......
...............
000000000000000
DIALOG